Tak tedy dobrý den , děkuji za pěkné přivítání . Děkuji za pozvání na toto zajímavou konferenci , kde se rozvídáme mnoho o různých kulturách .	And thank you very much for having me in this very interesting conference on diverse cultures .
Já bych se tedy ještě rychle krátce představila , jmenuji se Markéta Planá . Jak již bylo řečeno , působím na univerzitě v Plzni a působím tam jako kulturoložka a etnoložka .	My name 's Markéta Planá and I work at the University of Pilsen as a culturologist and ethnologist .
Zabývám se tedy především kulturou Lužických Srbů a lužickosrbskou menšinou v Německu . Jak už tady bylo tedy zmíněno .	I focus on the culture of Sorbs and the , and the people and everything around them , as has been already mentioned .
Přejdu asi rovnou k tématu , protože máme časové omezení , takže nebudu už úvod protahovat .	
Lužičtí Srbové . Nejsem si ani jistá , jestli všichni účastníci naší konference tuto menšinu znají , protože mnoho čechů o této menšině ani neví .	Sorbs , I 'm not even sure whether every , all the participants know of this ethnic minority .
Kdo jsou tedy Lužičtí Srbové a kde se vzali ?	Who are Sorbs and where do they come from ?
Lužičtí Srbové jsou malý západoslovanský národ a tento národ obývá jihovýchodní část východního Německa .	There are a small West Slavic nation that inhabits the eastern part of Germany .
Tato část Německa obývaná tímto národem se nazývá Lužice .	The part in eastern Germany that they inhabit is called Lusatia .
Je to opravdu jedinečná kultura , ale menšinová .	Their culture is very interesting , but it 's a minority culture .
A jak už bývá u menšinových kultur zvykem , pozvolna slábne .	And as it is typical for a minority culture , for minority cultures , they grow weaker .
To však neznamená , že si nezaslouží naší pozornost .	
Tento- Ještě ke všemu je tento národ nám čechům , já tady vím , že tady máme spoustu zahraničních hostů na této konferenci . Ale přesto budu odkazovat občas na nás Čechy , protože jsou to v podstatě naši příbuzní .	On top of that , for us , the Czechs , although I know that there are many participants from all over the world , but sometimes I will refer to Czechs .
Tento národ je nám historicky zkrátka blízký . Jedná se také o slovany , kteří mluví slovanským jazykem , což je i čeština .	So for us , for Czechs , it 's an ethnic group that 's close to us because they also speak Czech .
Lužice , jak už jsem tedy zmínila , tu to je ta oblast , kde oni bydlí nebo kde se vyskytují , jsou dvě .	Lusatia , the place where they live , where Sorbs live , has two parts , the upper and lower one .
Máme Horní Lužici , ta se nachází blíže k České republice a leží v Sasku , Tedy na území Německa ve spolkové zemi Sasko .	The upper one is closer to the Czech Republic .
A hlavním centrem Horní Lužice je město Budišín . Německy se toto město nazývá Bautzen .	It lies in Saxony and the capital is Bautzen .
A druhá Lužice je Dolní Lužice . Ta spadá pod spolkovou zemi Braniborsko a leží na leží na sever od Horní Lužice .	The other part is the Lower Lusatia in Brandenburg .
Tak tomu často bývá , že to , co je Dolní , vlastně leží severně od Horního . Tak je to příklad a případ právě i tady v Lužici .	Sometimes things are like this , that what 's lower is in the north from what 's upper and is in the south .
Srbové jako slovanský národ přišli do oblasti Lužice už před více než 1400 lety . Mají tedy za sebou pestrou historii .	Sorbs came to Lusatia more than 2,400 years ago , so they really have a very long , interesting history .
Prvním významným milníkem v historii Lužických Srbů nastal v 19. století .	The first turning point for Sorbs was in the 19th century .
Protože právě to byla doba , kdy si Lužičtí Srbové začaly více uvědomovat svou národnost . Zkrátka rostlo to národní vědomí .	This was a time when Sorbs started to realize , started to be more and more aware of their nationality .
A právě v tuto dobu se tedy začaly snažit prosadit své kulturní hodnoty , svůj jazyk .	And at that time they started to impose , to promote more their culture and language .
Například byla také povolena výuka na gymnáziu v srbském jazyce a tak dále .	Their language was even taught at some schools .
Také v roce dva- pardon , 1912 byla založena organizace Domovina a tato organizace existuje dodnes . Ta tedy také podporuje práva Lužických Srbů .	In 1890 , there was an organization called Domowina established and this organization exists even today and helps to promote the Sorbian culture .
A také v době NDR , tedy v době mezi rokem 1949 a mezi rokem 1990 se vlastně došlo k velkému rozkvětu této kultury .	Also , between the years 1949 and 1990 , the Sorbian culture flourished .
Rozšířili rozšířila se působnost . Například vznikl Srbský institut , vznikla různá nakladatelství , školy , divadla .	For example , the Sorbin Institute came into existence , and different schools and theatres emerged .
Takže právě když byla tady NDR , tak došlo k velkému rozvinutí této kultury . Ale i za to se muselo zaplatit , protože celá organizace Domovina , kterou jsem již zmínila , byla plně pod vlivem SED . Což byla tedy tehdy v NDR jediná vládnoucí politická strana .	So , in the Democratic Republic of Germany , during the existence of this republic , the culture flourished , but it was fully under the influence of the only ruling political party in GDR .
Co se týče jazyka . Tak Lužičtí Srbové si zachovali svůj vlastní jazyk . Jedná se o lužickou srbštinu . A je to stejně jako čeština západoslovanský jazyk .	The language of the Sorbs is the Sorbian , and similarly to Czech , it 's a West Slavic language .
A lužická srbština se stejně jako Lužice dělí na horno a dolno lužickou srbštinu .	Also , the Sorbian is divided into upper and lower variety .
Tyto jazyky jsou si hodně podobné .	
Dlouho však lužická srbština neměla jednotnou gramatiku . Nebyla nebyl to zkrátka kodifikovaný jazyk . A až v roce 1990 se lužická srbština stala úředním jazykem právě pro tuto oblast .	Sorbian for a long time didn 't have one grammar , it wasn 't a codified language and only as late as 1990 Sorbian became the official language for Lusatia .
V okolí Budišína , tedy jednoho z velkých měst ( lužické- ) Lužice , jsou ve vesnicích například dvojazyčné nápisy .	Around the city of Bautzen , one of the big cities of Lusatia , you can find bilingual inscriptions .
A všichni Lužičtí Srbové mluví ale zároveň i německy . Takže většina Lužických Srbů dnes jsou bilingvní .	But most of Sorbs also speak German , so most of Sorbs nowadays are bilingual .
Bohužel jsou ale i Lužičtí Srbové , kteří mluví pouze německy .	Unfortunately , however , there are also Sorbs that speak only German .
Neovládají srbštinu . A i proto tedy tento jazyk vymírá a s ním , spolu s ním i ta kultura .	They do not know Sorbian , and that 's a reason why the Sorbian language and culture are endangered and are becoming extinct .
Ale i tak můžeme lužickou srbštinu slyšet na různých místech . Existuje například Německo-srbské divadlo . Tam můžeme slyšet divadelní hry v lužické srbštině .	But you can list- , you can hear Sorbian , for example , in some theaters in &#91; NAME &#93; ( Lusatiat , Some performances are given in this language .
Dále existují tištěná média .	
Můžu zmínit například Srbské noviny nebo rozhlad . Takže čeští mluvčí tady v sále už na základě názvů těchto novin poznají , že opravdu se jedná o jazyk slovanský a příbuzný češtině .	You can also find some newspapers in Sorbia , so if Czechs were to read such newspapers , they would recognize immediately that Sorbian is a Slavic language .
Dále také můžeme slyšet lužickou srbštinu v německém rádiu .	
V německém rádiu MDR , které také část rozhl- nebo část vysílání odvysílá právě v lužické srbštině .	Then there 's also a Sorbian radio where part of the broadcasting is done in Sorbian .
A kromě toho nesmíme zapomínat , že tato kultura , tato národnostní menšina má své spisovatele . Mají své hudebníky , herce , novináře , filmaře , básníky , ale také malíře .	We mustn 't forget either that there are also Sorbian artists , filmmakers , poets , writers , but also painters , all the necessary links in culture .
Takže , jak vidíte , zkrátka všechny články kultury které známe .	
Tato národnostní menšina má taky své vlastní specifické tradice a zvyky . To je asi typické . To je typické pro vlastně jakoukoliv kulturu . Ale nebudu tady do detailů teď rozebírat jednotlivé tradice Lužických Srbů . Spíše kdyby měl třeba někdo o pauze , kdyby to někoho zajímalo , tak budu připravena na vaše otázky .	Sorbs also have their proper customs , something that 's typical for every different culture , but I don 't want to delve into Sorbian traditions , but if anyone are , is interested in them , you may ask me during the break , for example .
Ještě je potřeba zmínit , že Ústava Německa nezmiňuje menšinové národy .	I 'd also like to say that the German constitution does not talk at all about minority , about ethnic minorities .
Zkrátka , Ústava , německá Ústava pouze rozlišuje výraz občan , tedy Němec .	The German constitution talk only about a citizen that is a German .
A to neznamená , že by Lužičtí Srbové neměly nějaké , nebyly nějak právně ošetřeny .	That doesn 't mean that Sorbians wouldn 't be protected by any legal instruments .
Respektive ta menšina .	
Ale je to právně ošetřeno právě na úrovni jednotlivých spolkových zemí . Tedy na úrovni spolkových zemí Saska a Braniborska .	They are , but these legal instruments exist at the regional government levels , in this particular case of Saxony and Brandenburg .
A já bych je chtěla ještě , tedy kromě této teoretické části , kromě toho , že jsem vám představila tu kulturu a ten jazyk . Tak bych vám zde chtěla ještě přednést a představit výpovědi přímo Lužických Srbů . Tak , jak je řekly sami o sobě a o Němcích . A naopak výpovědi Němců , jak vnímají Lužické Srby .	So this was a small presentation of the Sorbian culture and language , and I also would like to present you with some commentaries of Sorbs themselves , about themselves , but also of Germans talking about Sorbs .
A tyto výpovědi , které vám zde přednesu , jsou vlastně z dotazníků , které prováděly naši studenti .	And these comments come from surveys that were carried out by our students .
Takže naši studenti , ať už osobně nebo písemně , se tedy ptali přímo přímo lidí z této národnostní menšiny .	So our students , either in a written or verbal form , asked directly people , for example , Sorbians .
Takže například Lužická Srbka , tedy žena ve věku 25 let . Lužické Srby popsala jako skromné lidi , přívětivé lidi a uvedla , že co se týče autonomie je spokojená .	So for example , a Sorbian female of 25 years old , described Sorbians as modest , friendly people and said that she 's happy as far as their independence goes .
Nepociťuje politickou diskriminaci . A fakt , že Lužičí Srbové umí dva jazyky vidí jako výhodu .	She doesn 't feel discriminated in any way and she says , sees the Sorbian bilingualism as an advantage .
Občas cítí ze strany Němců nedůvěřivost . A to zejména , když mluví srbštinou . A za za základní atributy Lužického Srba považuje náboženství a jazyk .	But she does feel a little bit or perceives a little bit of hostility from Germans when she speaks Sorbian .
Dále se vyjádřil Lužický Srb , tedy muž ve věku 40 let . A ten zdůraznuje , že v rámci Německa nemají Lužičtí Srbové žádnou autonomii .	Another Sorbian male of 40 years old said that within Germany , Sorbians have absolutely no independence .
Pochvaluje si tedy dotace od státu , ale nepovažuje je za dostačující .	But he is happy for subsidies from , or benefits from the state , but he doesn 't find them sufficient .
Také uvedl , že podle něj srbská kultura závisí na výchově rodičů a nikoli na státu . A tento muž tedy zařadil mezi hlavní atributy Lužických Srbů jazyk a pak teprve kulturu .	He also said that the Sorbian culture is very dependent on the education and upbringing at home , not on the education that the state gives to Sorbians .
A ze strany Němců mohu citovat například jednoho respondenta . To je muž ve věku 53 let a ten si myslí , že Lužičtí Srbové mají dostatečnou míru autonomie .	And as far as Germans are concerned , I can cite , I can quote a 53-year-old male who says that Sorbian independence is sufficient .
A největší chybu nebo největší nedostatek vidí v tom , že Lužičtí Srbové nezískali žádné křeslo v Zemském sněmu . Tedy v takzvaném Landtagu , v Sasku a Braniborsku .	He is only sorry that Sorbians did not get any seat in the so-called Landtag , the regional parliament in Brandenburg or Saxony .
Protože toto se povedlo například dánské menšině , zase v jiné spolkové zemi .	
A takže tedy vidíme , že ani jedna strana nepociťuje , že by Lužičtí Srbové byly nějak diskriminováni .	So you can see that neither side does feel anything negative of each other .
Ale samozřejmě toto byly pouze výpovědi některý- některého z mála respondentů . A samozřejmě jsme se nezeptali úplně všech . Takže jako vždycky i zde dochází k určitému zobecňování .	But , of course , as it 's typical for every survey , there is some degree of generalisation .
A na závěr bych ještě ráda dodala , že Lužičtí Srbové nejsou pouze v oblasti Lužice .	
Tedy tam v Branniborsku a Sasku , jak již bylo zmíněno . Ale Lužičtí Srbové žijí také třeba v Drážďanách , v Lipsku , v Berlíně . A žijí i mimo Evropu . Například v Texasu . Anebo také ve státě Viktória v Austrálii . A kromě toho žijí také v Jižní Africe .	I would like to also say that Sorbians also live in Dresden and Berlin , but also outside of Europe , for example , in Texas or in the state of Victoria in Australia or in South African , in the South African Republic .
Takže vidíme tedy , že jsou rozptýleni také po celém světě . A stejně tak jako účastníci dnešní konference .	So we can see that they live all over the world as well as the participants of today 's conference .
Takže já vám děkuji za pozornost . A o přestávce si kdyžtak vyslechnu vaše dotazy , kdyby vás zajímalo ještě něco ke kultuře Lužických Srbů .	Thank you very much for your attention and I 'm ready for any questions you have , for example , at the coffee break .
Děkuji .	Thank you very much .
