Okay , good afternoon , ladies and gentlemen , just let me share the screen with my presentation . @ Can everyone see the presentation ?	Dobrý den , budu ještě sdílet obrazovku se svojí prezentací . Všichni vidíte ?
I hope so . @ So again , good afternoon .	Doufám , že ano . Ještě jednou dobré odpoledne .
My name is Heather Simmons , and I work as a research officer and peer support worker for the UK based Birth Trauma Association , where our main concern is providing resources and support to parents who have had a traumatic birth experience , as well as spreading awareness and it is a great honor for me to be able to speak about this very important and serious topic at this conference .	Jmenuji se Heather Simmons a pracuji jakožto výzkumnice v Asociaci porodního traumatu . Chceme poskytovat zdroje a podporu rodičům , kteří zažili traumatické zážitky z porodu . Je pro mě opravdu skvělou zkušeností a tím , že můžu nyní tedy promluvit .
So when we talk about birth trauma , @ ... first we should probably explain what it even means .	Nejprve bych asi měla vysvětlit , co to je porodní trauma .
Birth trauma is a shorthand @ phrase for post-traumatic stress disorder or PTSD after childbirth .	Porodní trauma je taková kratší fráze , která popisuje posttraumatickou stresovou poruchu , která nastává po porodu .
We also use it for women who have some symptoms of PTSD , but not enough for a full diagnosis . PTSD was first identified amongst soldiers returning from the Vietnam War .	Jsou to lidé , kteří mají některé symptomy PTSD , ale nemají jich dostatek , aby měli tu celkovou diagnozu potvrzenou .
And most people still think of it as something , as a condition that 's experienced by soldiers or people who have been in a hostage situation , for example .	Mnoho lidí si myslí , že to je porucha , kterou trpí jen vojáci , kteří bojovali a tak dále , ale není to pravda .
In fact PTSD can follow any traumatic event and what is a traumatic event to you can be quite personal . @ It could be for example being in a car accident , being sexually abused or having a very difficult birth .	Může tím trpět kdokoliv , kdo prožil nějakou traumatickou událost . Například pokud byl přítomný u autonehody nebo například pohlavně zneužíván .
It can also happen to people who have witnessed a traumatic event .	Mohou to být také osoby , které byly svědky nějaké traumatické události .
So that means that , for example , people who have seen someone else violently killed , for example , often experience PTSD .	Například lidé , kteří byly svědky vraždy .
And this is why even some partners or even midwives could experience PTSD after seeing a traumatic birth . ...	To znamená , že dokonce i ty porodní asistentky mohou poté trpět PTSD kvůli nějakým traumatickým porodům .
	Pojďme se tedy podívat na to , co ženy prožívají za dramatické zážitky .
So who experiences birth trauma ? @ Some women experience @ events during childbirth as well as in their pregnancy or immediately after birth , that would traumatise pretty much anyone .	Ženy mohou prožívat tyto zážitky před porodem , během porodu i po porodu . Nejsou to ale vždy pouze nějaké dramatické události .
But for other women , it is not always the sensational or dramatic events @ that trigger childbirth trauma , but other factors such as loss of control , loss of dignity , hostile attitudes of the people around them , or feelings of not being heard , or , very importantly , the absence of informed consent to medical procedures .	Ale může to být také ztráta kontroly , ztráta důstojnosti , nebo nepřátelské chování jejich okolí . Dále to také může být pocit , že jim není nasloucháno . A nebo že jim chybí informovaný souhlas s lékařskými zákroky .
And it can mean many different things . @ Many things can trigger birth trauma such as lengthy labour or short but very painful labour . Induction for pain relie- pain relief .	To znamená , že to porodní trauma může být způsobeno mnoha mnoha věcmi . Například to může být také vyvoláním porodu a nebo nastřižením .
Feelings of loss of control as I mentioned . High levels of medical intervention . @ Emergency cesarean sections . Impersonal treatment and problems with staff attitudes such as not being listened to .	Může to být tím , že například na nich byly proveden císařský zákrok a nebo že jim nebylo nasloucháno . Také to může být tím , že nebylo rodičkám poskytnuto dostatek informací .
Or lack of information or explanation what is going on . @ Many women experience fear for baby 's safety , of course . @ Then there are situations such as stillbirth , which is very understandably traumatic .	Ženy se samozřejmě obávají i o bezpečí svého dítěte . A je samozřejmě i nebezpečí toho , že se dítě narodí mrtvé , což je velmi traumatizující .
But @ what we should focus on is , for example , how lack of privacy and dignity @ can affect birthing women . ...	Ale také to , že ženy ztratí důstojnost a kontrolu , může způsobit toto trauma .
And @ what 's also @ quite a huge risk factor is , of course , any @ history of previous trauma , for example , from the woman 's childhood @ or from a previous birth experience .	Velkým faktorem může být také to , že ve své minulosti už zažily podobné trauma nebo jiné trauma .
Women affected by birth trauma often find that there is nowhere to turn for them for support because a- even other mothers who have not had a traumatising birth experience can find it hard to understand @ the impact of a traumatic birth .	Ženy , které toto trauma zažijí a které jsou jim ovlivněny bohužel často nemají kam se obrátit . V jejich okolí mu často nedokáže porozumět .
This can make sufferers feel lonely and depressed and they often feel as they are somehow weaker than other women ... and they may feel incredibly guilty as a result .	Často mohou být osamocené a můžou mít deprese . A výsledkem je , že se cítí opravdu , mají velké pocity viny .
So this is a terrible burden to shoulder of course and the nature of PTSD means it 's impossible to stop constantly thinking about the birth experience .	Nemohou zastavit myšlenky na to , jak jejich porod probíhal a jaké trauma zažily .
But very few people are aware of this and even healthcare professionals don 't always understand . ...	
Unfortunately , @ this lack of support can mean that relationships with friends and family may deteriorate .	Bohužel to , že takovýmto , ženám není poskytnuta podpora , tak to má velmi špatné důsledky .
Many women end up feeling torn between their desire for more children , but they are also determined to avoid another pregnancy and they are terrified of it .	Ženy například už zvažují , jestli si pořídí další dítě , jsou vystrašené z dalšího těhotenství .
What 's quite serious is also that some women start avoiding any medical intervention that might remind them of their traumatic birth experience , such as smear tests .	Některé ženy se také naprosto začnou vyhýbat všem doktorům a všem lékařským zákrokům .
And for many women , the greatest concern is the day-to-day difficulties they face when they 're trying to bond with their new baby , who they see as a constant reminder of the trauma they 've experienced .	A pro většinu žen je asi největší trauma to , že mají problémy návázat pouto se svým dítětem .
And @ what might be quite a shocking thing to mention is that up to 45 % of new mothers have exp- have ex- reported experiencing some sort of @ traumatic birth experience .	A co může být trošku šok , je , že až 45 novopečených matek říká , že zažilo nějaké traumatické zážitky z porodu .
And when we talk about @ the topic of birth trauma , I think it 's very important to mention obstetric violence .	Myslím , že když se zabýváme porodním traumatem , tak je důležité mluvit také o porodnickém násilí .
Because there are many factors , of course , @ concerned about your health , for example , that you can 't really predict .	
But @ obstetric violence is behaviour that can be prevented and preventing it can mean pro- preventing great trauma . So what is obstetric violence ?	Samozřejmě , že porodnické násilí je něco , čemu se dá zabránit . A můžeme tak zabránit i tomu porodnímu traumatu .
Obstetric violence is in other words abuse during childbirth and it happens on a wide-ranging spectrum .	Porodnické násilí je hrubé chování zdravotnického personálu k rodičkám .
The World Hea- Health Organization notes that abuse during childbirth has yet to be conclusively defined or measured in a scientific way . However , it is generally defined as neglectful , physically abusive and or disrespectful treatment from healthcare professionals towards patients in childbirth . ... @ Such mistreatment is regarded as a violation of the woman 's human rights .	WHO ještě nevydalo nějakou oficiální definici , nicméně většinou se definuje jako zanedbávající fyzicky hrubé a nebo neuctivé zacházení s rodičkami ze strany zdravotnického personálu . A toto samozřejmě porušuje lidská práva ženy .
Obstetric violence is at its basis systemic institutional violence and that means that it isn 't usually motivated by the desire to cause harm but it 's often unconscious because of the system in which health professionals are educated and in which they subsequently practice their profession .	Je to systémové a institucionální násilí . Může být způsobeno buď tím , že opravdu ten personál chce být násilný , ale zároveň i tím , že se to ani neuvědomuje . Ale chová se k těm rodičkám nevhodně .
And they just consider this behaviour to be normal in many cases .	
And the institution , institutionality can be also seen in the hospital hierarchy and routine practices that are passed on within the practice . And there is just this attitude sometimes like it has always been done this way , therefore , that 's how it 's just supposed to be .	Bohužel často je toto chování normalizováno a považováno za běžné . V porodnicích jsou zažité postupy a hierarchie , které mohou poté působit právě to , že je toto chování bráno za normální .
And some examples of obstetric violence can be vaginal exams without consent , forced cesarean surgery , physical force to prevent birth while waiting for the doctor to come , @ physical restraint during birth , any sort of sexual comments or even assault during exams or procedures , bullying into procedures such as induction or cesarean section , @ failing to get free informed consent and being treated or spoken to drs- disrespectfully and without the regard for the personal autonomy of @ the woman or person giving birth . @ Next @ , I would like to move on to the preven- prevention part of my lecture .	Například , co může být příkladem porodnického násilí , je vaginální prohlídka bez souhlasu rodičky . Nucení do císařského řezu , fyzické bránění porodu . Také to , že jsou rodičky nuceny do vyvolání porodu , k nastřižení a nebo císařského řezu . Zároveň to může být to , že nejsou rodičky ze strany personálu informovány a nedají svůj souhlas k určitým zákrokům . A zároveň to může být také neuctivé jednání s rodičkou a neuznání její autonomie .
	To znamená , že se k ní chovají bez respektu .
And I would like to share with you the results of quite an interesting study that was conducted in 2017 in the Netherlands . @ The data was collected in March 2016 .	Chtěla bych se s vámi podělit i o výsledky velmi zajímavé studie , která byla provedena v roce 2017 . Data v ní zpracována byla se sbíraná v březnu roku 2016 .
And in this study , 2,192 women were surveyed .	Zapojilo se do ní 2192 žen .
And it was a retrospective survey among women @ who have one or more self-reported traumatic birth experience which @ have had to happen in 2005 or after , not before 2005 .	Byla to retrospektivní studie , která se ptala žen na to , jaké měly zážitky u porodu . Co tam tedy zažívaly a byly to zážitky od roku 2005 do roku 2016 .
And I want to focus on @ three main questions that these women were asked .	
First , they were asked what they attribute their trauma to , what 's the cause of their trauma . @ Then , what they feel their cay- caregivers could have done differently to avoid the trauma or if there is something they themselves could have done to prevent the traumatic experience .	Žen se nejprve ptali , čemu přisuzují vinu za ty traumatické zážitky , které při porodu zažily . Poté se jich ptali , co podle nich mohlo zdravotnický personál udělat jinak , aby se tomu traumatu vyhly . A za třetí , co oni sami mohly udělat jinak , aby traumatu předešly .
So I 'm going to start with the first question , the attribution of trauma . @ Here we can see the results .	Já bych tedy ráda začala tu první otázkou , čemu ženy přisuzují vinu za traumatické zážitky .
So most frequently perceived causes of or contributions to the traumatic experience were lack and loss of control , @ which @ said was the case , 54.6 % of the participants said that that was the case . @ Then we have fear @ for baby 's health or life at 49.9 % .	Jak můžete vidět v tabulce , tak velmi často , nebo nejčastěji , to byla ztráta kontroly nebo nedostatek kontroly . Tak to se vyjádřilo 54,6 % žen . Za druhé zde máme strach o zdraví dítěte a nebo o jeho život . To bylo 49,9 % .
High intensity of pain or physical discomfort at 47.4 % and communication or explanation or lack thereof I should say at 43.7 % .	Za třetí zde máme velmi intenzivní bolest a nebo fyzické nepohodlí . Tak to se vyjádřilo 47,4 % žen .
So and overview of the answers is shown here @ in this table What 's quite interesting is that out of the 51 participants whose baby had died , @ 62.7 % appointed a bad outcome as one of the causes of their traumatic experience , which of course makes sense , but the remaining @ 37.3 % mainly reported lack and loss of control , lack of communication or explanation , lack of respect or being taken seriously or just the way they were treated and @ lack of emotional and practical support from the caregivers .	Zároveň ženy také říkaly , že to byla komunikace , respektive to , že s nimi nebylo komunikováno a že jim nebyly vysvětlovány ty zákroky , které na nich byly prováděny . Dále ženy říkaly , že to byla právě ta ztráta kontroly , ztráta autonomie , to , že nebyly respektovány .
	A také nedostatek podpory ze strany partnera .
But @ what 's the main thing for me to take away @ from this part of the survey is @ that most women @ attribute the cause of the traumatic birth primarily to lack and loss of control and issues of communication and practical and emotional support . @ Then let 's move on @ to the next important part of the survey .	Myslím , že to , co bychom si tady z tohoto výzkumu měli odnést , je , že ženy většinou připisují to trauma právě k tomu , že ztratily kontrolu . A že neměly dostatek emocionální podpory . Pojďme se podívat na další část tohoto výzkumu .
And that 's when the women were asked what they feel their caregivers could have done differently to prevent their traumatic experiences .	Zde se žen ptaly , co by podle nich jejich ošetřovatelé mohli udělat lépe , aby nezažily toto trauma .
A minority of 12.4 % indicated that the caregiver could have done nothing to prevent the trauma . @ But what we see here again @ most preva- prevalently is to communicate or explain the situation at @ 39.1 % and then listen to me more , listen to the patient , listen to their wishes at @ 36.1 % .	A zhruba 12 % žen řeklo , že se nedá dělat nic . Nicméně , co ženy říkaly , že by měly dělat lékaři , je , že by měly komunikovat a vysvětlovat . To řeklo 39,1 % žen . Další přání bylo , aby jim více naslouchali . Toto si přálo 36,9 % žen .
	Zároveň si ženy přály , aby je zdravotnický personál více podporoval , aby je lépe podpořil .
So those were the most frequently chosen answers , followed by support me more or better emotionally and practically at 29.8 % as shown in the table .	Jak emocionálně , tak i prakticky . A to bylo 29,8 % .
And examples of lack of emotional or practical support given by women in the free text fields included in the survey were not being taken seriously in their perception of the speed of labor progression , being left alone during labor , no continuity of care , and a midwife or a gynaecologist who was too busy to spend time with them .	Ženy také říkaly , že je zdravotnický personál nebral vážně , že byli během porodu ponechány o samotě . Říkaly , že jejich porodní asistentka anebo lékař měli příliš mnoho práce a nemohli s nimi trávit dostatek času .
The answers most @ often ranked as the most important in this category were listen to me more at 20.6 % and communicate , explain to me @ at 19.7 % .	Ženy tedy říkaly , že by se mělo více vysvětlovat a 20,6 % říkalo , že by jim měli více naslouchat .
And , examples of commentaries of women in reference to the answer discuss expectations or birth plan were that a birth plan was not taken seriously . @ That they had not been realistically informed about the likelihood of cen- certain interventions or outcomes and that their an- @ that their antenatal course downplayed the actual pain involved , @ so-called painting rosy picture . @ And lastly @ , improvement in self-management .	Ženy také říkaly , že když si stanovily nějaký porodní plán , takže často byl ignorován a že jich přání nebrali lékaři vážně . Také ženy tvrdily , že bolest , kterou zažívaly , nebyla brána vážně . No a za třetí byla otázka , co si ženy myslely , že by mohly udělat lépe a jinak , aby zabránily traumatu .
That means that the women were asked what they themselves could have done to prevent trauma if there is such thing . @ The most frequently chosen answer to the question , what participants wanted to have done themselves to prevent trauma or decrease its impact was nothing at 37 % .	A byly to tedy otázky , co by ty ženy chtěly udělat a většina řekla , že nebo mohly udělat a většina řekla , že nemohly udělat nic . Říkaly , že se prostě některé věci stanou a že se jim nedá zabránit nebo předejít .
Of course , in many cases , there is really nothing you can do when such @ things happen to you . @ But then @ there was the option of ask for certain actions or interventions at 26.9 % and refuse certain actions or interventions @ as well at 16.5 % . So those were mentioned @ as most frequent .	Za druhé , ale ženy říkaly , že by chtěly poprosit o to , aby určité zákroky na nich nebyly provedeny . To bylo 26,9 % . A některé také tvrdily , že by chtěly odmítnout určité zákroky . A to bylo 16,5 % .
Analysis of the ranking in importance @ of the given answers identifying the same top three .	
Some examples of actions or interventions mentioned in the free text fields were cesarean section , pain relief , vaginal examinations and operative vaginal delivery . ...	Některé příklady zákroků které ženy zmiňovaly a byl císařský řez , také vaginální prohlídka , také například léky tlumící bolest a analgetika .
After analysing themes among frequently mentioned answers within the option other , @ the categories be assertive , express myself or remain in charge and make different choices in caregiver were added .	V té možnosti jiné , co znamená jiné odpovědi , ženy říkaly , že by se rozhodovaly jinak a tak podobně .
So , @ to conclude , what can we take @ from this ?	Co se tedy z tohoto můžeme odnést ?
Can child @ birth trauma be even prevented ?	Dá se porodnímu traumatu zabránit ?
Of course , childbirth doesn 't always go to plan .	Samozřejmě . Porod ne vždy jde tak , jak si představujeme .
Many women who experience birth trauma are unable to avoid it because the risk factors , for example , a history of trauma are beyond their control .	A žena bohužel zažije trauma , kterému se nedá předejít .
However , there are ways to help reduce the risk of birth trauma on both the parts of the caregiver , as well as the expectant mother .	Nicméně . Dá se určitými způsoby předcházet traumatu a například mu i zabránit .
So as a caregiver , I think that the key always is respecting informed and free consent . @ What we see @ from the research is that communication and explanation of everything that is going on is key . @ Caregivers should always discuss @ the birth plan of the mother and then stick to it , respect it as much as possible .	Co s týče zdravotnického personálu , tak si myslím , že naprosto klíčové je , aby respektoval informovaný souhlas . Za druhé by měl rozhodně komunikovat a vše pořádně vysvětlit . Zároveň by měl zdravotnický personál probrat ten porodní plán s rodičkou .
Try to treat patients with dignity and respect . Listen to them , listen to their wishes .	Měl by dále také , měl by se k ní chovat s respektem a s důstojností , zachovat její důstojnost .
If they 're not sure they can consult a doula or a midwife .	Personál by měl také konzultovat určité věci s porodní asistentkou nebo dulou .
They shouldn 't touch patients without permission , they shouldn 't use any kinds of threats in order to push certain medical procedures on @ the mother .	Neměl by se dotýkat pacientky bez jejího souhlasu . Také by rozhodně neměl pronášet nějaké hanlivé poznámky .
They should abstain from making any degrading comments of course and if @ as a caregiver you are interested in @ some tips @ on what to do there is @ at least that 's what we have in Britain there 's nice National Institute for Health and Clinical Excellence guidelines and there is especially one concentrated on @ the topic of childbirth and pregnancy care .	A pokud by zdravotníci chtěli nějaké typy . Tak Národní ústav pro zdraví a klinickou odbornost vydal instrukce , které se právě zabývají porodním traumatem a jak mu zabránit .
And I would also really @ support @ medical professionals in @ taking up any courses or getting more @ education on the topic of obstetric violence , for example in @ the Great Britain , we have the organisation Birth Monopoly that @ makes such courses for medical professionals and @ I don 't know if you have any equivalent of that @ in the Czech Republic but @ that would be great .	Rozhodně podporuji to , aby zdravotníci chodili na takovéto kurzy , aby se zajímali o to , jak zabránit porodnickému násilí . Například ? ? ? Monopoly pořádá podobné kurzy . Nevím , jestli máte nějakou obdobu těchto kurzů v České republice , ale rozhodně jsou velmi prospešné pro zdravotníky .
And what can you do as an expectant mother ? @ You should of course prepare for childbirth . You can take antenatal classes , for example , that will help you know what to expect and will tell you what @ your different options are . @ I would encourage you to explore your options . @ If you , for example , want a midwife or a doula present at your birth , we will hear more about @ different kinds , more alternative @ ways of giving birth @ and I encourage you to explore those as much as possible and find out if they might be right for you .	Co se týče matek , tak ty by samozřejmě měly podstoupit například nějaké kurzy , aby věděly , co je čeká . Hrozně bych rodičky také podnítila k tomu , aby se zajímaly o svoje možnosti . Dnes jistě uslyšíme o různých alternativách porodu . A já bych vás rozhodně chtěla podpořit v tom , abyste prozkoumali všechny možnosti a rozhodly se , které jsou pro vás vhodné .
It 's important to create a birth plan that will fit your needs and discuss it @ with your caregivers beforehand in detail . And of course , it 's good to try to have realistic expectations and open mind because there is no right way to give birth . Things always don 't go to plan and some things are beyond your control .	Zároveň si myslím , že je dobré si vytvořit porodní plán a probrat ho například s porodní asistentkou a sestavit ho tak , aby všem vyhovoval . Zároveň si myslím , že je dobré si zachovat určitá , určité realistické představy a jít do toho s otevřenou myslí .
No one can predict what will or won 't happen during pregnancy and birth .	Protože se může stát mnoho věcí během těhotenství i během porodu .
And with that , of course , because that 's a very difficult thing to do , to just deal with these facts @ , I would recommend you to seek mental health support , especially if you already have a history of trauma or if you are prone to anxiety or depression or if you 've had any difficult pregnancy or labor before . Counselling can help you come to terms with what happened and @ release any @ fear maybe you might have .	Také bych doporučila , abyste našli někoho , kdo vám pomůže s vaším duševním zdravím , kdo vás podpoří . Pokud jste například zažila nějaký těžký a traumatický porod nebo jinou traumatizující zkušenost , tak si myslím , že psychoterapie by vám mohla velmi pomoci .
And it 's also very important to establish a support network to surround yourself with people who can support you .	Je velmi důležité obklopit se lidmi , kteří vás podpoří .
And @ those are my most important points . And this is @ probably all I want to say .	Toto je to nejdůležitější , co jsem vám dnes chtěla předat .
Thank you for your attention .	Moc vám děkuji za pozornost .
