So good afternoon everyone or I could say Dobrý den všem . But that 's all about all from my Czech language knowledge .	Dobré odpoledne . Mohla bych říct dobrý den všem , ale to je asi vše , co všechny umím .
I used to live in Prague for a couple of months .	Já jsem Praze bydlela několik měsíců .
I did an internship here when I was at university some , how much , 20 years ago or so .	Bylo to , když jsem studovala na univerzitě , zhruba tak 20 let , 20 let zpátky .
So my Czech got a bit rusty since then .	
Anyway . My name is Kirsten McCrane .	Nicméně jmenuji se Kristin McCrane .
I was invited by the Prague Institute of Planning and Development to this conference .	
And I have to say , I was more than happy to accept the invitation .	A- Byla jsem zde pozvána a jsem velmi ráda , že jsem toto pozvání mohla přijmout .
I really love Prague . I love visiting Prague .	Miluju Prahu . Moc ráda ji navštivuju .
So it is a little sad that this conference is not held in person , but I 'm looking forward to visiting Prague in summer .	Je pro mě tedy trošku zklamáním , že tato konference není osobní , osobně prezenční . A že nemůžu naštívit Prahu osobně .
I 'm from Scotland , but you can proba- probably hear that . But I promise you I 'll try to moderate my accent .	Ale jsem tedy zde ve Skotsku a jsem skotská , jak asi možná slyšíte z mého přízvuku .
I 'm a Scottish MP , and I 'm convener of Parliament Net Zero Energy and Transport Committee .	Pracuji jako skotská poslankyně a jsem svolatelka výboru pro nulové čisté emisie , energetiku a dopravu .
So I 'm here today to tell you something about transport in big Scottish cities , and maybe give you some recommendations for Prague .	Dnes vám tedy povím něco málo o dopravě ve velkých skotských městech . Možná vám dám i nějaká doporučení pro Prahu .
I 'm not saying we have the best system in the world , but we try our best .	Neříkám , že ve Skotsku máme nejlepší systém na celém světě , nicméně opravdu se snažíme , aby naše doprava byla co nejlepší .
And apparently the IPR Prague thought , as they had invited me , that there 's something about our system that might inspire others .	Já věřím , že jsou určité prvky v našem systému , které by mohly Prahu inspirovat .
Scotland has been making great progress in promoting sustainable transportation in its cities .	Skotsko opravdu udělalo velký pokrok v oblasti udržitelné dopravy .
Many of the larger cities such as Edinburgh , Glasgow or Aberdeen have implemented a range of measures to reduce the environmental impact of transport and those cities want to promote more sustainable alternatives Scottish government and city municipalities have also been exploring innovative transport solutions to meet the needs of the population .	Například v Edinburgu , v Glasgowu nebo v Aberdeenu se zavedla mnoha opatření , které snižují dopad na životní prostředí . A cílem je tedy nabídnout udržitelnější dopravu . Ve Skotsku se snažíme přijít s novými inovativními řešeními .
And they also want to reduce carboned emissions , of course . So now I 'm going to give you a few examples from Scotland .	Tak abychom snížili emise CO2 a neměli takový dopad na životní prostředí , co se týče dopravy .
Firstly , Scotland has invested heavily in cycling infrastructure . including the development of dedicated cycle paths . And the government financially supports also shared bike systems and shared bike initiatives .	Skotsko velmi investuje do infrastruktury cyklistiky . Budují se cyklostezky a vláda také sponzoruje sdílené kola . To znamená , že jsou systémy , kde se sdílí kola ve městech .
In our committee , in my committee , we talk a lot about that .	
We overall think that cycling is sustainable and healthy mode of transportation . And we would love to encourage more people to- to choose cycling as their preferred mode of transportation or transport in the city .	V mém výboru opravdu věříme , že cyklistika je skvělý způsob dopravy , která je zdravá a je udržitelná . Je to opravdu dobrý způsob , jak se dopravovat po městě .
But to be honest , I myself , I 'm not a huge fan of bikes in city centres .	Já osobně , ale nejsem úplně fanynkou kol v centrech měst .
And I 'm talking mostly about shared bikes .	A mluvím specificky o těch sdílených kolech .
I 've noticed them also in Prague city center .	Vím , že jsou i v pražském centru .
And I always feel a bit anxious about people riding bikes in very crowded parts of the city , such as city centre .	A musím říct , že mě vždy docela znervozňuje , když vidím , že lidé jezdí na kole právě v centru Prahy .
Because let 's be honest , many people do not respect traffic rules . And they are a danger to themselves and to their surroundings .	Musíme být upřímní . Mnoho lidí nedodržuje pravidla silničního provozu a ohrožují tak nejen sebe , ale i ty , co jsou kolem nich .
But don 't get me wrong . I think that cycling outside the centre in surrounding quarters is a great mean of transport .	Nechci ale říct , že by cyklistika byla špatná obecně . Věřím , že mimo to centrum je to skvělý způsob dopravy .
Scottish cycling infrastructure has in this way been a tremendous success and we have seen a significant increase in the number of people cycling in Scotland 's big cities . So I believe that this approach might be an inspiration for Prague .	A skotský systém , který jsme zavedli , je opravdu úspěšný . A vidíme , že lidé čím dál více využívají ve velkých městech právě kol. Proto věřím , že náš přístup by mohl být pro Prahu inspirací .
Even though there is not much of a cycling tradition in Prague , and I know that many people are skeptical about increasing number of people using bikes , but this really could be a way to support greener transport in your city .	Samozřejmě v Praze není úplně tradice cyklistů a že mnoho lidí vidí vidí tento způsob dopravy spíše skepticky . Nicméně mohl by to být dobrý způsob , jak podpořit zelenou dopravu ve vašem městě .
Another initi- tiative that we have implemented in Scotland is the introduction of so-called low emission zones .	Ve Skotsku jsme dále zavedli tzv. nízkoemisní zóny .
What does that mean ?	Co to tedy znamená ?
Several Scottish cities have introduced low emission zones to-to reduce the impact of pollution on public health .	Několik skotských měst zavedlo tyto nízkoemisní zóny . Chceme , aby už tolik nebylo znečištění ovzduší a aby lidé byli zdravější .
The zones restrict the entry of high polluting vehicles such as older diesel cars and vans .	To znamená , že vozidla , například s dieselovými motory , nemají povoleno sem vyjíždět .
The introduction of low emission zones has been a significant step in reducing emissions and it also improves air quality in our cities .	Nízkoemisní zóny jsou opravdu skvělým krokem , jak snížit emise a také vylepšit kvalitu ovzduší v našich městech .
And I think that Prague could benefit from that too .	Já si opravdu myslím , že i Praha by toto mohla využít .
The city is full of cars , quite literally , So maybe- maybe by restricting high-polluting vehicles from certain areas in the city centre , people will be more ec- encouraged to use public transport , which is great , by the way .	Je to město plné aut. Možná tím , že byste omezili vjezd do určitých oblastí právě pro tyto auta , které opravdu znečišťují ovzduší , tak by se všechno zlepšilo .
I love taking Prague trams and metro .	Lidé by mohli využívat dopravu hromadnou a to já veřím , že hromadná doprava v Praze je opravdu skvělá .
And so those- those low-emission zones will , of course , also help to re- reduce air pollution .	Nízkoemisní zóny také pomáhají právě vylepšit kvalitu ovzduší .
And my third example , cities and transport companies in Scotland are massively investing in green transport technologies , @ such as electric buses for public transport and also hydrogen-powered buses .	A mám ještě jeden příklad , jak jsme vylepšili dopravu ve Skotsku . Naše města investují do zelených technologií . Například do elektrických autobusů a také do autobusů , které jezdí na vodík .
In Aberdeen , for example , there al- there are world 's first hydrogen-powered double-deckers .	V Aberdeenu například máme double-deckery , které znáte , takové ty dvupatrové autobusy , které jezdí na vodík .
And those emit zero emissions . These buses actually emit only water vapour and this makes them an environmentally friendly alternative to traditional diesel buses .	A tyto autobusy nevydávají žádné emise , ale jen páru . A je to určitě skvělá alternativa k těm klasickým autobusům , které všichni známe .
The bus fleet in Aberdeen helps reducing the carbon footprint and each bus , each bus saves 84 tons of carbon per year .	Snižuje se jejich uhlíková stopa . A každý autobus ušetří několik desítek tun CO2 za rok .
For me , this is the most innovative thing .	
We all know about alternative powered vehicles , alternative powers , but the point is that in Scotland , governments and municipalities are hugely supporting it , both financially and ideologically .	Všichni známe vozidla , která jezdí na alternativní zdroje energie . Nicméně ve Skotsku se vládá a také úřady snaží podporovat nejen finančně , ale i ideologicky právě tyto zdroje .
And I think , from what I can , that this is the key problem in Prague .	A já myslím , že to je ten klíčový problém v Praze .
You could easily start to introduce alternative , greener means of transport , but I feel that the will and support from- from above is missing in Prague .	Nebylo by vůbec těžké tady zavést zelenou dopravu . Já mám ale pocit , že to vedení tady nemá vůli něco takového udělat .
I can- I could talk for ages about innovative transport in Scotland , and I could introduce you more great projects and examples .	O innovativní dopravě ve Skotsku bych mohla mluvit opravdu dlouho a představit vám další projekty .
But we don 't have time for that now . So if you 're interested @ , do not hesitate to ask now , or you can easily contact me later .	Na to ale nemáme není čas. Pokud by vás to tedy zajímalo , tak se mě rozhodně zeptejte na nějaké otázky .
	Anebo mě můžete kontaktovat po konferenci .
I genuinely believe that creating sustainability in transport and finding new solutions can make a huge difference overall .	Opravdu věřím , že když budeme mít udržitelnější dopravu a budeme hledat nová řešení , tak opravdu zlepšíme náš svět .
And it can really help . It- it does not help only our planet , but mainly it helps us , citizens of the cities .	Nepomůže to jen naší planetě , ale pomůže to hlavně nám . Nám , občanům , kteří v těch městech žijí .
However , in big cities , as I tried to explain , it all has to start from above and there has to be a lot of investment and encouragement from above .	Jak už jsem říkala , tak to musí ale začít z těch nejvyšších pater . Ta změna musí vycházet od nich . Musí podporovat tyto změny a musí do nich investovat .
But then it can work as it works in Scotland and I believe it will soon work in Prague too .	A když se to stane , tak to bude fungovat stejně , jako to funguje nyní ve Skotsku . Já věřím , že to tak brzo bude i v Praze .
Thank you very much .	Moc vám děkuji za pozornost .
