Dobrý den , dámy a pánové . @ Vítám vás na @ konferenci Jak moderní technologie pomáhají v rozvojovém světě .	Good afternoon , ladies and gentlemen . Welcome to our conference on how modern technologies help in the modern world .
Mé jméno je Kateřina Malá a zastupuji tady Informační centrum OSN a budu dnešní konferenci moderovat .	My name is Kateřina Malá . And I 'm here from the Information Center of the UN .
	And I 'm the moderator of today 's event .
A kromě toho jsem si také pro sebe uzmula roli první řečnice , protože v té své úvodní přednášce bych chtěla poskytnout takový obecnější rámec k tomu , o čem tady dneska bude řeč .	And I 'm also the first speaker . In my lecture , I will like to tell you about the wider framework of what I 'm going to be- of what we 're going to be talking about today .
Jak jsem říkala , tak zastupuji @ Informační centrum OSN , což je @ jedno z celé celosvětové sítě informačních center , které informují o tom , jaké jsou vlastně činnosti , cíle a priority OSN .	I 'm from the Information Center of the UN , as I said , which is a part of a worldwide network of information centers informing about the goals and priorities of the UN .
A možná taková zajímavost .	
Česká republika , respektive to naše informační centrum v České republice , bylo jedno z vůbec prvních zastoupení OSN ve světě . @ Tahleta kancelář , původně se jmenovala jinak , ale to je celkem jedno , začala fungovat už roce 1948 . To znamená , že naše informační centrum už má 75 let dlouhou tradici .	The Czech Republic or our information center is one of the first of the centers in the UN . This- this office used to be named something else , but it started functioning in 1948 , so it has a really long tradition .
A jak jsem říkala , naším cílem je tedy zprostředkovávat informace o činnosti OSN , a součástí této aktivity je právě i ta dnešní konference .	Our goal is to provide information about the activities of the UN . And one of these activities is today 's conference .
Cílem téhle konference je ukázat příklady dobré praxe , motivovat , inspirovat a možná vám i pomoci najít odvahu hledat neprobádené cesty a využívat moderní technologie i třeba způsoby , které nejsou na první pohled zřejmé .	We want to show good examples of good practice and maybe inspire you to find new ways of using modern technologies , maybe in ways that might not be clear at first glance .
Konkrétně pro pomoc těm vůbec nejzranitelnějším lidem v rozvojovém světě .	And what we want to do is help the most vulnerable people in the developing world .
Naše konference bude mít dva bloky .	This conference is going to be in two blocks .
A @ v tom prvním bloku @ uslyšíte tedy tu moji úvodní přednášku o @ cílech udržitelného rozvoje . A potom @ tady budeme mít hosta , který bude mluvit o francouzské @ zkušenosti , konkrétně o využití dronů v zemědělství . A potom vystoupí @ naše hostka ze Španělska , která bude mluvit o takzvaných reverzních inovacích .	In the first block there will be this lecture of mine about the Sustainable Development Goals and there will be the next guest @ from France talking about using drones in ag- agriculture and then we will have our Spanish guest talking about so-called reverse innovation .
A ukáže nám , že technologie , které pomáhají v rozvojových zemích , vlastně nemusí být až tak high-tech a že často i úplně běžné věci každodenní potřeby a trocha vynalézavezti stačí , aby jsme přišli z nějakou inovací , která bude lidem pomáhat .	What she will show us is that the technology is helping in developing world don 't has- don 't have to be that high-tech as we usually imagine . That even everyday things and a little bit of innovative thinking is enough for an innovation that really helps people .
Tohle všechno tedy zazní v prvním panelu .	So this is what we are going to hear in the first panel .
K tomu , co nás čeká v tom druhém , se ještě dostanu .	And about the second one we are going to talk about later .
A teď už tedy k mé prezentaci .	So here goes my lecture .
Takže já doufám , že bude fungovat sdílení prezentace .	I hope the presentation is working just fine .
Zdá se , že všechno funguje .	It seems to be working OK .
Doufám , že moji prezentaci vidíte .	I hope that you can see my presentation just fine .
Pokud byste měli problém a místo toho třeba viděli mě a ne prezentaci , tak si můžete dole vlevo na liště kliknout na prezentaci a místo toho uvidíte prezentaci místo mě . @ Takže já doufám , že všechno technicky funguje a můžeme se do toho pustit .	And if there is an issue and you see me and not the presentation , you can click on the presentation down on @ screen . So I hope everything is working and let 's go .
Pardon .	
Pojďme tedy na to . Cíle udržitelného rozvoje .	Okay , so let 's talk about @ the Sustainable Development Goals .
Já bych chtěla v téhle prezentaci hovořit o tom , co to vlastně cíle udržitelného rozvoje jsou , kde se vzaly , jak se jich daří dosahovat a taky proč vlastně jsou relevantní pro tu naši dnešní konferenci .	I would like to talk about what they are , where they come from , how are we managing to achieve them , and why are they r- relevant for today 's conference .
Co to tedy cíle udržitelného rozvoje jsou ?	So what are Sustainable Development Goals ?
Často se pro ně používá zkratka SDG , což je tedy zkratka z angličtiny , Sustainable Development Goals .	We often use SDG for them , which of course may Sustainable Development Goals .
A @ jsou to tedy cíle , je jich 17 , jsou vzájemně provázané , a jejich smyslem je dosáhnout míru a prosperity pro všechny lidi , ale také i pro naši planetu .	And there are 17 goals that are interconnected . And what we want to do with them is to gain peace and prosperity for all people and our planet .
Takže skutečně tam hraje velkou roli ta udržitelnost .	
A myslí se tím udržitelnost v tom nejšírším možném slova smyslu . Takže bavíme se tady o udržitelnosti ekologické , udržitelnosti sociální . Smyslem zkrátka je , abychom jako lidstvo fungovali s ohledem jeden na druhého a také s ohledem a brali tedy ohled jeden na druhého , ale také na naši planetu .	Which means that sustainability is key and it means sustainability @ in its widest @ range of meaning - social , environmental sustainability in order to function for us @ and being kind to each other and to our planet as well .
Těch cílů je tedy 17 a já si samozřejmě neodpustím je tady všechny představit .	There are 17 goals , as I said , and of course I want them- want to show them all to you .
Takže číslem čís- , @ pardon , cílem číslo 1 je konec chudoby . Potom tady máme konec hladu . Zdravý a kvalitní život .	Number one is ending poverty , then ending hunger , health and quality of life .
Cíl číslo 4 je kvalitní vzdělání a potom je tady rovnost mužu a žen .	Number four is quality of education , then gender equality .
Cíl číslo 6 se zaměřuje na pitnou vodu a kanalizaci .	Number six is about drinking water and sewage .
Potom tady máme dostupné a čisté energie , důstojná práce a ekonomický růst .	Number seven is affordable and clean energy , fair work and economic growth .
A cíl číslo 9 je průmysl , inovace a infrastruktura .	Nine is industry , innovation and infrastructure .
Cíl číslo 10 je méně nerovností .	Ten is less inequality .
Cíl číslo 11 jsou udržitelná města a obce .	Eleven , sustainable cities and municipalities .
Potom čí- cíl číslo 12 , odpovědná výroba a spotřeba .	Twelve , responsible production and consumption .
Potom je to klimatická opatření , život ve vodě , život na souši . @ Císl- Číslo 16 je mír , spravedlnost a silné instituce .	Thirteen , climate measures . Forty , aquatic life , land life . Sixteen , peace , justice and strong institutions .
A potom tady máme poslední 17. cíl , partnerství ke splnění cílu .	And the last one , 17 , is partnership in order to meet these objectives .
Takže sami vidíte , že ten poslední 17. cíl je takový trochu meta cíl , protože zkrátka abychom všech těchhle ambiciozních cílů mohli dosáhnout , tak potřebujeme táhnout za jeden provaz , potřebujeme spolupracovat .	So you can see that the last goal has a little bit of a meta goal because in order to reach all of these goals , we of course need to cooperate . We need to be in a partnership .
Jak už jsem říkala , tak tyhlety cíle jsou velmi ambiciozní a také jsou velmi širokce pojaté , řekněme .	As I said , that these goals are quite ambitious . And @ they are quite wide and @ not so concrete maybe sometimes .
Takže abychom jich vůbec mohli dosáhnout , tak je potřeba si je rozdělit na nějaké , řekněme , menší dílčí kroky , či dílčí cíle .	So we need some specific steps in order to achieve them .
Takže každý z těch velkých cílů je rozdělen na 8 až 12 dílčích cílů . A abychom mohli sledovat , jestli za těch cílu dáří dosahovat nebo ne , tak ještě pro každý ten dílčí cíl je nastaveno několik indikátorů , které se potom pravidelně sledují , aby skutečně bylo možné říct , k tomuhle cíli jsme se přiblížili o tolik , k tomuhle cíli jsme se zatím moc nepřiblížili , protože ty cíle nemají zůstat jenom na papíře .	So each of these goals has 8 @ to 12 specific goals for them and for each of these there are four- @ one to four indicators for each of these @ small specific goals so we can see where we are on the way of reaching them because of course they- we don 't want to- them to remain on paper but @ we need to try to implement them . So for these , indicators are a great thing .
Skutečně nám jde o to , abychom jimch dosáhli , a musíme se tedy bavit i o tom , jak je implementovat a tomu pomáhají @ sledování toho pomáhají ty indikátory .	
Kde se vlastně cíle @ udržitelného rozvoje vzaly ?	So where did the SDGs come from ?
Zlomovým rokem je v tomhle případě rok 2015 , protože do roku 2015 existovaly takzvané rozvojové tisíciletí . To byl rozvojový program , který si kladl za cíl odstranit největší problémy rozvojového světa .	The key year is 2015 , because until 2015 there were the Millennium Development Goals , which was a development program , which tried to remove the greatest issues of the developing world .
Ten program se realizoval od roku 2000 právě do toho roku 2015 a zahrnoval osm cílu .	So this program started in the year 2000 till the year 2015 and there were eight goals .
Jedním z těch cílů bylo například boj s chudobou .	One of them was fighting poverty .
A tohohle cíle se podařilo dosáhnout už v roce 2008 , se podařilo snížit počet lidí , kteří musejí vyžít s jedním dolarem na den , na polovinu .	And we managed to reach this goal in 2008 . We managed to lower the number of people who @ live in extreme poverty .
Takže vidíte , že byť jsou ty cíle často ambiciozní , tak je možné jich dosáhnout .	Even those girls are quite ambitious . We can still achieve them .
Na druhou stranu ne všech těch cílů se do roku 2015 dosáhnout podařilo a ne všech se také podařilo dosáhnout všude na světě ...	However , not all of the girls were reached until 2015 . And not all of them were reached all around the world .
Z toho důvodu se začala potom tedy připravovat takzvaná Agenda 2030 , která nastavila těch nových 17 cílů udržitelného rozvoje .	For that reason , @ the Agenda 2030 started being prepared , which gave us the Sustainable Development Goals .
Tahleta agenda , která se konkrétně jmenuje Přeměna našeho světa , agenda pro udržitelný rozvoj 2030 , byla schválena 25. září 2015 a platí tedy až do roku 2030 .	This agenda is called transforming our world and Agenda for Sustainable Development 2030 and it was agreed upon on the 25th of September 2015 and @ it is valid until the year 2030 .
Jak už jsem zmiňovala , tak nechceme , aby @ ty cíle zůstaly jenom na papíře .	We don 't want these goals to remain on paper .
To znamené , že se sleduje , jak se nám jich podaří dosáhnout nebo daří dosáhnout .	We need to implement them , so we need to check on the progress we are making .
A každý rok @ se vydává zpráva o pokroku , takzvané SDG Progress Report . A jednou za pět let vždycky se přezkoumávají ty cíle a vyhodnocují , a za tenhle přezkum je zodpovědná Statistická komise OSN . @ Můžeme se dy podívat na to , co nám říká ta poslední hodnotící zpráva z roku 2022 .	Every year , there is a progress report , an SDG progress report , and in every five years , there is a review by the UN Statistical Commission . We can have a look at the last report from the year 20- @ 2022 .
A asi vás nepřekvapí , že ta zpráva není úplně optimistická . @ Z té zprávy je zjevné , že @ v posledních několika letech @ bojujeme hned s několika různými krizemi , @ které navzájem @ působí , a to své působení vlastně ještě zesilují .	And it 's not quite so optimistic , which may not be a surprise . In the last couple of years , there has been a sequence of several different crises which are intersecting . And they make each other worse .
Takže @ ať už je to Covid-19 nebo třeba válka na Ukrajině , je to zkrátka několikátá krize , kůli kterým nejenže se nedaří dosahovat těch cílů , ale v některých případech se dokonce ty problémy ještě zhoršují .	So there was COVID-19 , there 's the war in Ukraine , there are many different crises that @ are making things worse and make it hard to reach our goals .
Dalším , co ta zpráva @ říká , je , že v současné době zažíváme vůbec největší množství konfliktů celosvětově od roku 1946 , což zase opět ničemu nepomáhá .	Another thing the report says is that currently there are the most conflicts @ in the whole world since the year 1946 , which isn 't helping either .
Nemluvě o tom , že @ současný stav klimatu naší planety nelze popsat jinak , než jako klimatickou katastrofu .	And then there is the climate crisis , of course , which could be called a climate disaster .
Takže to zase není něco , co by nám pomáhalo těch cílm dosáhnout .	So again , that 's not really something that would help us to reach our goals .
A všechny tyhlety problémy , všechny konflikty , pandemie , válka na Ukrajině , klimatická katastrofa . Tohle všechno dopadá vůbec nejvíc na ty naprosto nejzranitelnější .	And all of these issues and conflicts , war i- in Ukraine , the climate disaster , these are things that affect the most vulnerable people the most , which are people in developing countries .
A těmi nejzranitelnějšími jsou lidé v rozvojových zemích , a v nich jsou to především ženy a děti ...	And in those , it 's mostly women and children who are affected the worst .
Kromě toho ale je potřeba si uvědomit jednu věc .	Besides that we need to realize one more thing .
Že tedy ano , nejsme na tom úplně dobře , ale ty cíle udržitelného rozvoje jsou cestou , jak vyřešit většinu těch problémů , @ kterým v současné době čelíme .	We may not be doing so well , but the Sustainable Development Goals are a way to solve most of these issues we are facing right now .
Takže nejenže rozhodně není na místě @ od těch cílů ustupovat nebo se jich zbavovat .	So that means that we shouldn 't give up on these goals in any way .
Naopak .	It 's quite the opposite .
Musíme napřít ještě více sil k tomu , abychom těch cílů dosáhli . Protože je to právě udržitelný rozvoj . Je to právě snaha o udržitelnost ve všech jejich možných aspektech .	We need to keep trying much harder to reach them because it 's the sustainable development and trying to be as sustainable in many aspects as possible .
Je to právě to , že budeme respektovat potřeby ostatních lidí a budeme se nejvíc zaměřovat na pomoc těch nejzranitelnějších .	And it 's respecting other people 's needs . And trying to help the most vulnerable .
Tohle všechno jsou věci , které nám mohou pomoci vyřešit problémy dnešního světa a tím dosáhnout těch stanovených cíů ...	These things , other things that could help us to solve these world issues and therefore reach our Sustainable Development Goals .
Proč vlastně jsou dneska pro tu naši konferenci @ tyhle cíle relevantní ? @ Protože to , co uslyšíme , ty jednotlivé prezentace jednoznačně ukazují , že někdy stačí i málo , jeden dobrý nápad , a mů- ten může vyřešit spoustu problémů a tím nás přiblížit k tomu , abychom dosáhli některého z těch příslušných @ cílů udržitelného rozvoje .	So why are these goals relevant to today 's conference ? They 're revelent- relevant because what we are going to hear here today in these different lectures will show us that even one good idea can solve a lot of issues and therefore get us closer to reaching these Sustainable Development Goals .
Takže cílem je motivovat , inspirovat a ukázat , že to jde .	So we want to give us motivation and inspiration and show us that success is possible .
Ty dnešní přednášky nám třeba ukážou , jakým způsobem lze přispět ukončení chudoby . @ Zaměří se na ten cíl konec hladu . Stejně tak cíl zdravý a kvalitní život . Kromě toho také důstojná práce a ekonomický růst .	Today 's lectures will show us how we can end poverty , how to end hunger , how to get us more health and higher quality life , fair work and economical growth , responsible production , or land life .
Průmysl inovace a infrastruktura .	
Odpovědná spotřeba a výroba .	
Nebo třeba ten zmiňovaný život na souši . Takže tyhle všechny cíle @ nějakým způsobem budou dneska v těch prezentacích figurovat , i když to možná , i když tam možná nebudou zmíněny úplně explicitně .	These are the goals that could be helped @ by the ideas presented in today 's presentations . Even though they mi- they might not be explicitly mentioned , they still are interconnected .
Ale všechny ty prezentace ukazují , že , jak už jsem říkala , někdy stačí jenom trochu vynalézavosti a je možné udělat obrovské kroky kupředu .	So what we want to show is that even like a little bit of innovation sometimes can give us huge progress .
To je , řekla bych , asi všechno , co jsem chtěla za sebe zmínit @ v téhleté své úvodní prezentaci .	It was everything I wanted to tell you in my presentation .
A říkám si , že možná na dotazy je ještě trochu brzo , ale doufám , že nějaké přijdou . A vzhledem k tomu , že tedy dotazy si spíš necháme na později , tak už bych chtěla uvést @ dalšího řečníka .	And I 'm thinking it might be a little early for a Q &amp; A , but I 'm also really hope that there will be some questions , even though we will answer those later .
A tím bude Diran Makinde , @ který tady zastupuje africký panel pro nové technologie .	I would like to give the floor to another speaker , which is Diran Makinde .
A on bude mluvit o využití technologií v sektoru , se kterým si možná moderní technologie tak úplně nespojujete . A to je zemědělství . @ Nicméně , zemědělství je právě oblast , která se teď velmi velmi snaží zavádět inovace a moderní technologie .	He is from the panel for new technologies and he will talk about a new sector and new technologies and then in sectors agriculture . Which is @ a part of the industry that tries to involve more technological innovation .
A konkrétně tedy Diran nám představí , jak se pro takzvané precizní zemědělství využívají v Africe drony .	And Diran will talk about using drones in agriculture .
Takže já doufám , že @ Diran nás slyší a doufám , že bude moct i nasdílet svoji prezentaci .	So I hope Diran can hear us and that he will have no issues sharing his presentations .
Kdyby to náhodou nefungovalo , tak to určitě vyřešíme .	If any issues come up , we 'll can deal with those .
Ale Dirane , máte slovo .	Diran , please , you have the floor .
