Dobrý den a nesmírně vám děkuji za pozvání i za váš úvod .	Hello and thank you for having me .
Jsem moc ráda , že se této konference mohu účastnit . Velice ráda vidím , že je diverzita tak výrazným tématem .	I 'm very happy that diversity is such an important topic that so many people talk about .
Za prvé bych vám chtěla představit naši organizaci .	First , I would like to introduce my institution .
Jedná se organizaci , která se nazývá Dům světových kultur . Naše asociace byla zarožena v roce 1982 .	My institution is called the House of World Cultures it was established in 1982 .
Původně ji založil šerif Kaznadar , který je francouzsko-syrským básníkem .	Originally it was established by Sheriff Kazmodar , who is a poet .
V současné době je stále předsedou naší asociace , a to i přes jeho vysoký věk . Sídlíme v Paříži .	He is still the president of our association , even though despite his high age , and the institution is based in Paris .
Cílem naší asociace je podporovat kulturní výměnu a diverzitu . A to jsme mezi všemi národy světa .	Its goal are , is promotion of diversity and culture among all the nations of the world .
Kulturně se jí podporujeme dál tak , aby se rozširovala do všech koutů světa .	We also try to inform on diversity so that it 's spread all over the world .
Čím dál tím více se zajímáme o některé specifičtější věci .	But we also focus on more specific issues too .
V rámci- V současné době se naše organizace nejvíce ( zajímá ) kulturním dědictvím .	Our organization currently deals with the intangible cultural heritage .
Kulturní dědictví je velmi často založené na písmu a předmětech jako takových .	For example , Europeans , because as opposed to Europeans whose heritage is based on , for example , written documents and other monuments .
Dovolte mi nyní , abych vám představila aktivité naší instituce . Operujeme v nejrůznějších oblastech . Zaprvé představujeme různá divadelní představení .	So what we do is that we , that we for example , present different theatrical performance , performances .
Máme to velké štěstí , že máme divadelní sál , ve kterém můžeme představovat právě různá divadelní nebo taneční představení a podobné věci .	We are very lucky to have premises , several kinds of premises where we can present dance shows and theatrical performances .
Každý rok také organizujeme velký festival . Jedná se o festival Neskutečno . Poprvé se odehrál v roce 1997 a od té doby se každý rok odehrává v Paříži .	We also have a festival that was celebrated for the first year in 1997 , and since then it 's freq- , it 's regularly repeated .
Tento festival poskytuje náhled na nejrůznější kultury světa .	
Prezentujeme na něm nejen tradiční kulturní díla , ale také současná kulturní díla a nové umění .	It 's , it takes place in Paris , and we present there contemporary arts , but also French art .
Na tomto festivalu spolupracujeme s celou řadou dalších organizací a muzeí . Dovolala bych si zmínit několik z nich , které možná znáte . Jedná se například o Institut arabského světa , o Peru Bastý , anebo o muzeum na nábřeží Bráni .	We organize , we cooperate with many different organizations , for example the Arab World Institute , the Opera Bastille or Quai Branly Museum during this festival .
To se konkrétně věnuje exotickým uměním .	
V rámci tohoto festivalu představujeme nejrůznější umělecká představení . Účastní se toho totiž umělci z celých , ze všech částí světa .	At the festival we present different artistic performances and we have participants , artists from all over the world .
Za ty roky , co náš festival funguje , se nám totiž podařilo vytvořit poměrně širokou síť pracovníků . A už víme také , na koho se obrátit .	During the time that the festival is , has been organized , we 've managed to create a wide net of co-organizers and collaborators .
Díky tomu opravdu představujeme kvalitní umění .	
A jak už jsem zmiňovala , představujeme jak umění tradiční , tak umění zcela nové .	And as I 've said , we present traditional art as well as modern art .
To je totiž také významnou součástí kulturní diverzity .	Because this also forms an important part of cultural diversity .
Jak jsem se již zmiňovala , tento festival byl vytvořen před několika desítkami let a odehrává se v Paříži . V současnosti už se ale týká prakticky celé Francie . Festivalu se totiž účastní celá řada institucí i mimo Paříž .	The festival was created , was established a few decades ago and it 's held in Paris , but really it 's celebrated all over France because many different institutions from all over France take part in it .
Kromě představení nabízíme také různé místa a příležitosti pro reflexy , protože organizujeme konference a výstavy .	Besides performances , we also offer various spaces and opportunities for reflection , because we organise also exhibitions .
Kromě organizace tohoto festivalu ovšem , máme i několik dalších úkolů .	Besides the festival and its organisation , we have also other tasks .
Zaprvé se soustředíme na vzdělávání a také výzkum , který naše instituce provádí .	We focus on education and research that 's carried out by our institution .
Před několika lety jsme ve spolupráci ( uří- ) s pařížskou univerzitou měli možnost se soustředit na oblast antropologie . A to konkrétně na etnoscénologii .	A few years ago , together with the University of Paris , we , for example , focused on the ethnical performances .
Jedná se o zcela novou antropologickou disciplínu . Tato disciplína se zabývá rituály v jednotlivých kulturách . Zabývá se také hodnotovými žebříčky .	It 's a completely new field of study that deals with rituals of cultures and also with culture , with value ranking .
My se snažíme tuto doménu zkoumat a přinášet nějaké výsledky .	
Před několika lety jsme také vytvořili francouzské centrum nehmotného kulturního dědictví .	A few years ago we also created a French Centre of Intangible Cultural Heritage .
Toto centrum se nachází ve Francii v Bretani . A jedná se o nesmírně velké dokumentární centrum , ve kterém může najít nejrůznější uměleckou tvorbu z celého světa . Většina z této tvorby je v současnosti přístupná online .	This centre is based in France , in Bretagne , and an enormous documentary facility where you can find works from all over the world and most of these works are currently available online .
Dále také nabízíme celou řadu vzdělávacích kurzů . Snažíme se totiž propojit nemateriální kulturní dědictví a umělce jako takové .	We also offer an array of educational courses because we want to link intangible cultural heritage with artists .
Celá řada osob totiž neví , jak pracovat s nemateriálním kulturním dědictvím a jak ho zapojit do aktivní kultury .	The reason is that many people don 't know how to work with intangible cultural heritage and how to use it in art .
Snažíme se o tom tedy dostatečně informovat .	So this is something that we would like to promote .
Snažíme se také pomáhat jiným uměleckým programům a aktivitám .	We also help other artistic programs and activities .
Nabízíme například profesionální konzultace . Pokud chcete třeba zorganizovat vlastní festival . A nebo naplánovat nějaký kurz ve školách .	We offer professional consultations in case you wanted to have your own festival or a course at school .
Naši experti nám pomohou vám vymyslet , na jakou část kultury se soustředit a jak takovou akci zorganizovat .	Our experts , our professionals will help you with what segment of culture to focus on and of the organization itself .
Nemusí vždy jít o tak velké akci , jako je festival , ale klidně o menší akci .	There 's no necessity to want to found a huge festival .
Můžete se tedy informovat o našem know-how , na kterém jsme pracovali v posledních 30 letech .	
Dům světových kultur se ale dále soustředí i na jiné aktivity .	The House of World Cultures also take part in other activities .
Organizujeme například REVIE , které funguje už od roku 1994 a koná se víceméně jednou za dva roky .	We organise a revue , for example , that 's held , that 's been held since 1994 and it 's held every two years .
Soustředí se hlavně právě na nemateriální kulturní dědictví .	This revue focuses on the intangible cultural heritage .
Nyní mi ještě nakonec dovolte zmínit několik dalších našich hlavních aktivit .	To conclude , I would like to mention a few more of our activities .
Před pár lety jsme vytvořili hudební vydavatelství INEDIT .	A few years ago , we created a music label called Inedit .
V rámci tohoto hudebního vydavatelství nabízíme celou řadu kolekcí tradiční hudby .	At this label , we offer an array of musical collections .
Z největší části se jedná o ohroženou hudbu .	Most of them are cases of endangered music .
Dále ale také nabízíme samozřejmě i novou hudební tvorbu a ne pouze tu tradiční .	But we also offer new musical creation , not only the traditional .
Snažíme se tím o kulturní a diverzní obohacení .	We really want to enrich people .
Vytváříme taky zvukové archivy , které prakticky neznají hranic , protože obsahují hudební tvorbu ze všech koutů světa .	And we want to offer music as wide as , we want to provide as wide musical offer as possible .
Veškerou hudební tvorbu doprovázíme popisky , kterou které můžete najít ve francouzštině i v angličtině .	Everything is tagged in French and in English .
Tyto popisky sepisují odborníci na dané téma .	These tags are done by experts in the particular field .
Pokud je to potřeba , můžeme nabízet i překlady některých textů písní .	If necessary , we can also offer translation of some of the lyrics of the songs .
V současné době máme poměrně ohromující sbírku a jsme na ní velmi pyšní .	We are very proud of the services we can provide .
Doufám , že budete mít příležitost si pustit něco z hudby , kterou sbíráme za poslední desetiletí .	I really hope that you will have an opportunity to listen some of the music that we 've been collecting for the past decades .
Dále také doufám , že budete mít příležitost se podívat na některé z představení , které organizujeme . A že vás tento zážitek obohatí . A obohatí i váš přístup ke kulturní diverzitě .	I also hope that you will have an opportunity to see one of the performances that we organized and that it will be enriching for you and it will help you with your attitude to cultural diversity as well .
Děkuji vám za pozornost a jsem vám k dispozici , pokud byste měli nějaké dotazy .	If you have any questions , I 'm very happy to answer them .
Děkuji vám .	Thank you very much .
