Dobrý den všem .	Hello to you all .
Moc se omlouvám , ale nové technologie nemám moc v lásce .	I 'm very sorry , but new technologies are not my favorite thing .
A necítím se moc pohodlně v tomto momentu , ale doufám , že bude všechno v pořádku , že mě slyšíte .	I 'm not , I don 't , I 'm not feeling very comfortable now , but hopefully everything goes well now .
Mockrát děkuji za pozvání .	Thank you very much for the invitation .
Je pro mě velkou ctí , že zde mohu vystoupit na této konferenci .	It 's a great honour for me to be a part of this conference .
Jmenuji se Lilia Fernández Sousa a jsem z Mexika .	My name is Lilia Fernandez-Souza and I come from Mexico .
Pracuji na Yucatánské univerzitě jako archeoložka .	I work at the University of Yucatan as an archaeologist .
Zaměřuji se na klasické období majské kultury .	My focus is the classical period of Mayan culture .
Proto bych ráda hovořila o majské kultuře a také o majském písmu .	Therefore , I would like to talk about the Mayan culture and Mayan script .
Tématem naší konference je kulturní rozmanitost .	The topic of this conference is the cultural diversity .
Toto téma se tedy velice hodí .	This topic is therefore very suitable for this conference .
Všichni víme , že abychom mohli poznat kulturu , musíme ji také rozumět .	In order to get to know the culture , we have to understand the culture .
A může se zdát velmi těžkým úkolem porozumět kultuře , která je velmi odlišná od té naší .	It may seem a difficult task to understand a culture that is very different to ours .
Nyní si ale představme , že jsme archeologové a chceme poznat nějakou starou kulturu .	But now , let 's imagine that we are archaeologists , archaeologists , and we want to get to know an old culture .
To jediné , co k dispozici máme , jsou fyzické předměty , jako třeba keramika nebo kosti .	The only thing we have is , for instance , ceramics or some bones .
A jenom na základě toho musíme vytvořit historii této kultury .	And only on these basis we have to create or recreate the history of this culture .
Téměř nemožné , že ?	It seems impossible .
My archeologové jsme opravdu luštitelé .	We archaeologists really decipher history .
Někteří si to připouští a někteří ne .	
Co je ale velmi frustrující je , že nějaká kultura má písmo , které je nerozluštitelné a nerozluštěné .	But what may be quite frustrating is that a culture has a script that is impossible to decipher .
To se stalo archeologům na přelomu 19. a 20. století s majským písmem .	It happened at the end of the 19th century with Mayan script .
Archeologové , kteří se touto kulturou zabývali , nebyli schopni číst jejich písmo .	Archaeologists who looked at this culture weren 't able to read the script .
Jedná se o nápisy , které se nacházely v Mexiku , Guatemale nebo Belize .	This was , for instance , about information that were found in Guatemala , Mexico , and other countries .
Nápisy majštiny se nacházely především na pyramidách a na kamenných ( stélách ) .	These messages in Mayan language were found on pyramids , for instance .
Vědci neměli ani ponětí o tom , co takové písmo může znamenat .	Scientists had no clue whatoever what this script may mean or what information it , it has .
Majské písmu existuje dodnes , ale už v 16. století se umění psát a číst majské písmo ztratilo .	The Maya script exists still today , but in the 16th century the art of writing and reading Mayan script got lost .
Těmto neznámým znakům se říkalo hieroglyfy .	These unknown symbols were called hieroglyphs .
Správnější označení je ale logogram .	But a better term for this is so-called logogram .
Logogram , tedy obrázek , který představuje neboli popisuje jedno slovo .	It 's a picture that stands for one word .
Majské písmo se používalo pro vyprávění životu . života elit anebo pro vyprávění o náboženství .	The Mayan script was used for storytelling , telling stories of the elite or about religion .
Majské písmo jsme nenašli jen na veřejných prostranstvích ve městech , ale také v kodexech , v rukopisních knihách .	The Mayan script wasn 't found only in public spaces , but also in manuscripts .
Existuje pouze pět kodexů na celém světě a to je zvláštní , protože májové psali hodně .	There are only five manuscripts in the whole world , which is quite strange because the May culture was based on writing .
Velká část těchto kodexů byla zničena v 16. století františkánským biskupem Diego de Landau .	Many of these manuscripts were destroyed by a bishop from the order of monks .
Diego de Landa zničil téměř veškeré majské rukopistné knihy , protože popisovali heretické náboženství májů .	The manuscripts were destroyed because they were describing pagan religion of the Mayan culture .
Zároveň ale tento františkanský misionář napsal zprávu o věcech na Yukatánu v originálu Relación de las Cosas del Jucatán .	But at the same time he wrote a report about the issues of Yucatán .
Autor této knihy popsal v jedné části knihy majské písmo .	The author described Mayan script in one part of this ...
A proto abeceda majského písma , ačkoliv víme , že se jedná o logogramy a ne o abecedu , je nazvaná takzvanou landovskou abecedou . V roce 1862 se tento rukopis našel v Madridu .	Therefore , the alphabet of the Mayan script , these Mayan logograms , in 1862 , this manuscript was found in Madrid .
A tak díky této knihy knize mohli archeologové a vědci pokračovat ve výzkumu rozluštění majského písma .	And thanks to this book , the archaeologists and scientists could go on with the research regarding the description of the Mayan script .
To se nepodařilo až do 50. let 20. století .	It was only in the 50s when this took place .
Jedná se o velmi zajímavou historku .	
Až do konce druhé světové války písmo nebylo rozluštěno .	Until the end of the Second World War the script wasn 't deciphered .
Až do doby , kdy mladý sovětský voják našel v berlínské knihovně knihu , která ho velmi zaujala .	It was only until a Soviet soldier found a book in Berlin , a book that was quite interesting for him .
Tento voják se nazýval , se jmenoval Jurij Knorozov a jednalo se právě o zprávu o věcech na Yukatanu .	His name was Yuri Knorozov , and what he found was the reports about the issues of the Yucatán .
Knorozov byl student historie , tuto knihu odvezl do Sovětského svazu a tam ji začal zkoumat .	The soldier was a history student . He took the book to the Soviet Union , and he started to look into the book .
Pustil se tedy do práce rozluštění majských symbolů .	He started deciphering the Mayan symbols .
V roce 1952 publikoval článek , kde vysvětloval některé principy majského písma .	In 1952 , he published an article , and in the article , he was describing the principles of the Mayan script .
Vysvětoval tedy to , že některé ( abecedy ) symboly abecedy Diegade Landi jsou nejen písmena , ale jedná se o celá slova .	He explained that some symbols of Diego de Landa 's alphabet aren 't only letters , but whole words .
Později se tedy podařilo rozluštit další symboly a slova a dokonce i některé texty .	Later , it was therefore possible to decipher more words and sentences .
Odborníci na majskou kulturu se ale prací tohoto mladíka příliš nenadchli .	Experts of the Mayan culture weren 't very happy about the work of this soldier .
Navíc dalším odborníkem byl Erik Thompson , který byl odpůrcem práce Juriho Knorozova .	Another expert was Eric Thompson , who wasn 't in favor with this work .
Myslel si , že jeho práce není vědecky založená .	He believed this work is not scientific at all .
Samozřejmě tento problém byl také ve spojení s se studenou válkou .	This problem , it was also related to the Cold War .
Můžeme tady vidět , že světová politika hrála významnou roli také v archeologii .	We can see , therefore , that the world politics played an important role in archaeology , too .
Což je věda , která se zabývá velmi vzdálenou minulostí .	It 's a science that looks into a very remote history .
Nicméně Erik Thompson rozluštil některé majské symboly .	However , Eric Thompson deciphered some of the symbols .
Největší práce na rozluštění majského písma začaly v 70. letech 20. století .	The first work started in the 70s .
Přispělo k této práci především americká skupina odborníků vedená Lindou Schill .	The work was contributed by an American group of experts led by Linda Schele .
Tito odborníci ( vyleštili ) vyluštili mnoho dalších neznámých symbolů z majského písma .	These experts deciphered many more unknown symbols from the Mayan script .
A tak dnes díky práci mnoha výzkumníků jsme schopni přečíst velkou část majských symbolů a porozumět do určité míry majské kultuře .	Therefore , today , thanks to the work of many researchers , we are able to read a great deal of Mayan symbols and we can also understand the Mayan culture to some extent .
Zatím máme před sebou mnoho práce , ale už nějaké znalosti o majské kultuře díky rozluštění jejího písma máme .	A lot of work lies ahead of us , but at least we have some knowledge about the culture because of deciphering the script .
Jak už jsem řekla , majština se používala pro popisování života lity a popisování náboženství .	As I have said , the Mayan language was used for storytelling and telling the stories of elites and religion .
A tak možná nikdy nebudeme vědět , jak vypadal život běžných obyvatel , kteří používali májštinu jako svůj jazyk .	Therefore , we may not know ever how the life or the life of the normal people looked like .
Já jen doufám , že v budoucnu se nám podaří rozluštit mnohem více a poznat více o této vzdálené a zvláštní kultuře .	I hope that in the future we 'll be able to decipher even more and that we will learn much more about this remote and interesting culture .
To je vše z mé strany .	That 's all from me now .
Děkuji , že jste mě vyslechli a doufám , že jste se něco zajímavého naučili .	I thank you for your attention and hopefully you also learned something new .
Děkuji .	Thank you very much .
