Thank you very much , Madam Chair . And I want to thank the organisers for inviting me to this conference , which has really been fantastic so far . I 've really enjoyed the discussions .	Moc děkuji a chtěla bych také poděkovat všem , kteří mě zde pozvali . Je úžasné tady být a a všechno si to tady vyslechnout .
I want to talk about one @ particular area of consumer protection in the broadest sense , which is advertising regulation , which , just like consumer protection itself , has undoubtedly been a very good thing .	Já budu mluvit o jedné konkrétní oblasti a to je regulace reklamy . Samozřejmě , že je velmi důležité chránit jak spotřebitele , tak i korporace .
And it has been immensely useful because it helps protect people against corporations , who are , by definition , much larger and much stronger than we are .	
But while consumer protection on the whole , globally , has been improving over time , and the line goes steadily upwards , and has been going for decades now , the situation with advertising regulation has been getting steadily worse .	Ochrana spotřebitelů se sice v poslední době zlepšuje , je má poměrně stabilní nárůst , tak poté ale regulace v oblasti reklamy bohužel jsou čím dál na horší úrovni .
And I don 't want to sound too despondent here , but I don 't think it can get any better . Or if it can , I honestly don 't see how .	Bohužel se obávám , že to že to už snad nemůže být ani horší .
Let me explain what I mean .	
What is advertising regulation ?	Co tedy je regulace reklamy ?
Well , in the broadest sense , it 's a set of rules , different in each country , which basically govern what you can or cannot say in ads and who you can target with your ads .	Obecně je to nějaký soubor pravidel v určité zemi , které udávají , jak nakládat s reklama- s reklamami , jak je třeba cílit a tak dále .
	Můžu říct příklad .
Typically , these have the form of laws that say , for example , a very basic example , you can 't say in an ad that food supplement X will cure your cancer , because it won 't . But you can say that X has been shown to improve prognosis of certain types of cancer in rats , something like that . @ We know this .	Například v reklamě nemůžete říct , že ten a ten lék vylečí rakovinu . Ale můžete a nemůžete říct , že například to pomáhá například v právě v té léčbě rak- léčbě rakoviny .
It 's fairly common . Also , many countries regulate @ intoxicating @ addictive substances like alcohol , nicotine .	V mnoha zemích jsou omezené reklamy , co se týče například gamblingu a drog a například cigaret a tak dále .
Gambling is sort of adjacent to that . @ Or they regulate that you can 't show advertisements for these kinds of products to minors .	Takže to se samozřejmě nesmí poté tyto reklamy cílit na nezletilé uživatele .
For example , the @ state of Victoria in Australia has a law that says you can 't display ads for alcohol within 150 meters of a school . @ In Ontario , in Canada , it 's 200 meters from a school .	Nesmí být tedy například zobrazovány nebo někde vylepeny například reklamy 150 až sto- 100 metrů od školy reklamy na alkohol .
Things like that .	
You find examples all over the world .	
And I would argue that this is a good thing . And I don 't think that 's a controversial opinion , honestly .	A já bych řekla , že to je dobrá věc , že to je dobrý krok . Není to asi úplně kontroverzní .
But the world of advertising has changed tremendously in the last few decades , and the law has had a very hard time catching up to it . And not just the law , but everybody .	Nicméně svět reklamy se během posledních deseti let dramaticky změnil . A právo , právní rám- rámec má velmi , velmi problémy dohnat tento pokrok .
Because the laws and all the regulations that we have are based on the very simple concept that you can distinguish between ads and everything else that are not ads .	Právo , které nyní máme , je založené na velmi jednoduchých pravidlech . Rozlišuje se jenom , co je reklama a co není reklama .
And I 'm aware that this sounds very stupid , but bear with me , I 'm actually going somewhere with this .	
May I ask for my first slide ?	
Thank you . @ This is an image of a high- highway somewhere in America .	Tady na prezentaci vidíte nějakou americkou dálnici .
I don 't know where .	
It doesn 't really matter . And you can very clearly see the billboards there . Those are ads .	Je velmi očividné , že to , co je na billboardu , tak to je reklama .
And everything that 's not a billboard is not an ad .	A co není na billboardu , to není reklama .
This is pretty simple . And you can regulate this .	A samozřejmě to je velmi jednoduché , to se velmi jednoduše reguluje .
And you can regulate how many @ billboards there can be per one mile of high- highway . You can regulate that these ads may not be too distracting for drivers , so say nothing electronic , nothing animated , that kind of thing .	Můžete si určit , kde ty billboardy budou , můžete si říct , ano , tady třeba budou rušit řidiče , takže je tam nedáte a tak podobně .
The same analogy can apply to newspapers or TV , but we have a fairly clear boundary between what are ads and what are not ads .	To samé se dá uplatnit třeba i na televizi nebo noviny . Takže to je jenom otázka , co je a co není reklama .
But that 's the highway .	Jenže to je dálnice .
Today , most money in advertising is generated on what in the 1990s people called the information superhighway , which is the Internet .	V dnešní době ale je většina reklamy na jiné cestě a to je informační dálnice .
And yes , in the 90s people did call the Internet the information superhighway , I know . @ Things look different there , but they didn 't always . @ At first , in the early days of the Internet , @ at first , there were no ads whatsoever , but then people started using ads . And the earliest ads still used the same basic concept . May I have the next slide , please ?	Tím samozřejmě myslím digitální prostředí . Tam už to vypadá trošku jinak . U začátku internetu žádné reklamy nebyly . Nicméně poté se samozřejmě začaly i do tohoto prostředí dostávat .
This is it . These are called banners , advertising banners .	Tady vidíte tzv. banerové reklamy .
And these are images that are simply added to a page .	Jsou to obrázky , které jsou velmi jednoduše rozeznatelné .
And you can very easily tell that they are not part of the page .	
It 's very clearly defined . This is actually an ad .	Hned uvidíte , že to je reklama .
And there are two problems with this . @ One is , it turns out that people don 't click on these , ever . @ These are sold per impression , which basically means that the advertiser- you pay the advertiser money , and they will show this ad to , say , 1,000 users .	S tím se ale pojí dva problémy . Lidé na tyto reklamy neklikají , prostě je ignorují . Zároveň tedy se toto zobrazí jenom omezenému počtu sledujících nebo uživatelů toho internetu .
And of those 1,000 users , well , maybe one of them will click on it , if you 're really lucky , but probably not . @ I don 't know . @ Please raise your hands if anyone 's ever clicked on one of these things and it wasn 't an accident .	Třeba tisícovce . A to je samozřejmě velmi omezený počet . Můžete zvednout ruku , jestli někdy někdo klikl na takovou reklamu .
	Vidíte ?
See , no one does , ever . @ And in part , there 's a second reason to this , because these are really easy to block .	Nikdo . A poté zde máme druhý důvod . Tyto reklamy se velmi jednoduše blokují .
You can just tell your internet browser that you don 't want to see this .	Stačí si do svého prohlížeče nainstalovat program , který je zablokuje .
And because it 's so clearly separated from the page itself , the browser can very easily do that .	A ten prohlížeč to zvládá velmi jednoduše .
Many have these options built in , others you can install it very easily , and then you just don 't see these .	Pok- buď to ten prohlížeč už má zabudované , anebo si tam toto jednoduše nainstalujete .
And I 've been using ad blockers like these for literally decades , and I often forget that these banner ads actually still exist , which they do , and they shouldn 't , because they honestly don 't work , and they never worked .	Já blokuju reklamy ve svých prohlížečích už opravdu dese- desítky let a vlastně ty reklamy vůbec nevidím . Takže tyto reklamy tedy nefungují .
And the people who are selling them know this as well as I do .	A lidé , kteří dělají reklamy , tak to ví .
But things are different now .	V dnešní době je to tedy ale jiné .
And I have two prominent cases I want to mention here .	Máme zde mnoho případů .
One is a giant American corporation , which is called Alphabet .	Například tady máme korporaci Alphabet .
It 's entirely possible this does not sound familiar to you , because the corporation is far better known as Google , though the official name is Alphabet .	Nejspíš ji znáte pod jiným jménem a to je Google .
And there 's a second US corporation , which is called Meta .	A poté máme druhou americkou korporaci .
Again , you may not be familiar with that .	
It 's better known as Facebook , and Instagram , and other things as well .	A to je meta . Nejspíš ji znáte pod jménem Facebook .
So what do these gigantic corporations do ?	Co tedy tyto obrovské korporace dělají ?
They sell ads .	Tyto korporace prodávají reklamy .
They are by fa- far the largest advertising agencies in the whole world .	Jsou to největší prodejci reklamy na světě .
They do other things as well , quite a lot of things actually .	
Google runs this search engine you may have heard about , and Facebook has a social network which is fairly popular here .	Google má ten vyhledávač , o tom jste určitě slyšeli , a Facebook je také poměrně popula- populární .
But these are kind of secondary .	Toto je ale pouze s- sekundární věc .
The main business of these companies is selling ads . That 's why they 're so incredibly rich .	Tyto společnosti zbohatly právě na tom , že umožňují na svých platformách reklamy .
And the trick to their ads is that they are sort of invisible . That 's the point .	A problémem je , že ty reklamy jsou neviditelné .
May I have the next slide please ?	
Thank you . This is what happened when I typed smartphone into Google .	To , co se stalo , když jsem do Google napsal chytrý telefon .
My question is , where are the ads in this picture ?	Možná si řeknete , co je tedy reklama a co ne .
It 's a trick question .	A je to takový chyták .
It 's all ads . Everything you see there are ads .	Všechno to jsou reklamy .
Actually , if you scroll a bit down , you can 't see it here . But there 's a link . You can 't see it , so don 't even try . There 's a link to Wikipedia , which explains what a smartphone is , in case you don 't know .	Kdybyste sjeli ještě níže , ne , ne , v prezentaci ne , ale kromě toho , že je tam tedy nějaký odkaz na Wikipedii , který vysvětluje , co to jsou chytré telefony , tak jinak to jsou všechno reklamy .
But all these are ads . And you can tell these are ads by the , see the little words , sponsors there .	A to zjistíte jen díky tomu , že nahoře nad tím je vlastně napsané Sponsored , neboli sponzorováno .
It 's okay , never mind .	A toto nejdřív Google vůbec nedělal .
	To začal dělat nedávno .
The sponsors means that it 's an ad .	Takto začal označovat reklamy .
But actually when Google started doing this , when at first it didn 't do that , when they started doing this , the search results that were actually ads had this yellow box around them , and they were really easy to spot .	Nejprve měly tyto označení žlutý rámeček , takže se jich šlo velmi jednoduše všimnout .
But over time it got subtler and subtler , and these days you actually really have to pay attention to notice that it 's an ad . And it 's getting harder and harder .	Ale posléze se tyto rámečky odstranily a teď už je velmi těžké si jich vůbec všimnout .
It 's very similar with Facebook and all the others , where they integrate the ads with your feed , so it becomes one stream of content , and it 's becoming very hard to tell what are ads and what are not ads .	Můžete je úplně úplně přehlédnout . Proto už je opravdu velmi těžké rozeznat , co je reklama a co ne .
It 's just one giant stream . And , there 's more than that , because , and this is something we all know , ads on these platforms are personalised .	Je to jen obrovský proud článků a dat. No a my všichni asi víme , že ty reklamy na těchto platformách jsou personalizované .
Over time , as you use them , they build a profile of you .	Jsou přizpůsobené jednotlivým spotřebitelům .
They are very good at estimating your age , your gender , your interests quite accurately .	Ony se přizpůsobí vašemu věku , vašemu gendru .
And then they show you ads tailored to that .	
So if you tape- if you type smartphone into Google , and if I- I type smartphone into Google , we will see slightly different things .	Takže když potom napíšete do Googlu chytrý telefon , tak já a vy uvidíme něco trošku jiného .
I see different ads than you do .	
	Bude to založeno na tom , kdo jsme .
And my question is , going back to the start of this , how the hell do you regulate that when everyone sees something different ?	A když se tedy vrátím na začátek , jak tohleto regulovat ? Jak to udělat , když každý vidí něco trochu jiného ?
Because , making sure that there are no billboards promoting alcohol within 200 meters of a school , well , that 's easy enough .	Je poměrně jednoduché zajistit , aby dvě stě metrů od školy nebyly billboardy s reklamou na alkohol , ale to nestačí .
But how do you ensure that a minor won 't see any ad for alcohol on Instagram or TikTok or wherever ?	Jak to udělat , aby děti neviděly reklamu na alkohol třeba na Instagramu ?
That 's very difficult .	Je to opravdu velmi složité .
And I can assure you that the kids are paying a lot more attention to their phones than some kind of- some billboard on the street .	Můžu vás ujistit , že děti mnohem více jsou na tom mobilu , než se dívají na billboardy na ulici .
Now , in theory , the platform should be responsible for that , and they should not show problematic content to minors .	Problematické výrobky typu alkohol by se dětem ukazovat neměly .
And they have solutions that are trying to do this , because remember , they know a lot about their users .	
But you also need to realise that there are no actual humans involved in this whole process .	Co je důležité si uvědomit , ale je , že v celém tomh- tomhletom procesu nejsou vůbec zapojení lidé .
The people who buy ads buy ads from robots , and the ads are displayed to users by robots .	Už od toho kupování reklamy po to následné zobrazení .
And whatever the ro- robots are programmed to do , mistakes will inevitably happen .	Proto se t- často proto často dochází k pochybením , k chybám .
And if they do happen , well , good luck trying to make Google accept some kind of responsibility .	A je těžké dohnat tyto platformy poté k odpovědnosti .
If you look at the numbers , @ last year , in 2022 , Google made a- or Alphabet , doesn 't matter- made a profit of 60 billion American dollars .	Google vroni vloni vydělal 60 miliard amerických dolarů .
60 billion with a B. That 's pretty much the same as the GDP of Slovenia in 2022 .	To je zhruba HDP Slovinska za rok 2022 . Je to obrovská částka .
And it 's more than the GDP of 100 entire countries .	
And the company is , of course , headquartered in America , which means that we as Europeans can do very little about them . And the European Commission , I think , could confirm this because they 've been trying to work with them for years and it 's never been easy .	A tato společnost je samozřejmě v Americe , což znamená , že to ovlivnit nemůžou nemůžou třeba úřady mimo Ameriku . Evropská komise by o tom určitě mohla vyprávět .
And even if Google actually chose to blatantly ignore all the rules and interlaced videos for five-year-olds with ads for online poker and cocaine , there honestly really isn 't anything you can do about that .	Není samozřejmě možné , aby pětileté děti se dívaly na reklamy například na kokain nebo něco podobného , ale bohužel je velmi těžké tomu zabránit .
And there 's a whole different can of worms that I don 't quite want to open here , which is when it comes to political ads .	A to už nemluvě o politických reklamách .
Because where- This is where it gets really crazy , because political ads don 't deal with products , but with ideas .	Ty totiž neobchodují s výrobky , ale s myšlenkami .
And a political ad , a sponsored link to a political ad , may not look anything like an ad . It can look like an article .	Politické reklamy mohou vypadat jako cokoliv , může to být obyčejný článek .
And countries , of course , do have rules for spending on election campaigns .	
But this makes it nearly impossible to enforce them , because it 's incredibly opaque . And telling what is and isn 't an ad is nearly impossible . @ I was at a conference recently . @ It was a conference organized by @ one software company , a @ very big one , which shall remain nameless , but a very big one .	Poté tedy je velmi těžké vůbec usvědčit , že to je reklama , protože oni se můžou vymluvit , toto je obyčejný článek , to je prostě názor a tak dále .
And they showed this tech demo . @ Which- @ And they illustrated how they can , in real time , track a user 's movements on the internet and show them ads based on what they are currently doing .	Jedna softwarová společnost uspořádala takovou událost a tam ukazovali , jak vlastně se sleduje sleduje činnost jednotlivých uživatelů na internetu .
So in the demo , they had this lady who , on her laptop , was looking at some shoes in an online store . And she seemed to like them based on how long she spent looking at them .	Byla tam nějaká žena , která se na svém počítači dívala na boty a vypadalo to , že se jí líbí , protože se na ně dívala poměrně dlouho .
But she didn 't buy them .	Ale nekoupila si je .
And then the system could tell that she @ abandoned her laptop , she picked up her phone and started browsing through Instagram . and so into her Instagram feed they started injecting ads for those shoes from that particular store and added a discount on top of that to make her go back to her laptop and buy those shoes and that kind of thing and they were immensely proud of it .	A oni poznali , že ona si asi vzala do ruky mobil a ž- začala se dívat na Instagram . A proto ty reklamy na na boty začaly zobrazovat na jejím Instagramu . A to jich donutilo , aby si znovu sedla k počítači a koupila si je . A byli na to strašně pyšní .
And people were applauding and they thought it was wonderful and I stood there and thinking this is really creepy and really dystopian and there really should be a law against this kind of thing , but even as a lawyer , I don 't even know where we would begin regulating this . So that 's the situation where we are right now .	Lidé v publiku si mysleli , že to je úžasné . Ale já si myslím , že to je opravdu děsivé . Že to je skoro dystopie . Jakožto právník si ale ani nedokážu představit , kde začít , co se týče těchto regulací .
It 's big business , it 's very big business there 's lots of money involved so it will obviously continue and the corporations will pour incredible resources into it that we can 't possibly compete with , and honestly I find it kind of sad that we 're wasting this much human ingenuity and incredibly powerful technology on such an incredibly stupic- stupid purpose as showing people advertising .	Opravdu se zde točí velké peníze . Takže tento byznys asi bude určitě pokračovat . Korporace do něj investují neskutečné množství peněz . Myslím , že je to opravdu smutné , že vlastně investujeme tolik do technologií a tolik lidských zdrojů do této problematiky , do toho , aby lidé byli ovlivňováni reklamami .
But that 's how it is , because there 's a lot of money involved .	Tak už to ale prostě chodí .
And where there 's a lot of money involved , and we 're talking about literally billions of dollars every single year , the regulations are unfortunately quite powerless .	Jsou do toho zapojené peníze , je to obrovské množství peněz , jsou to miliardy dolarů každý rok . A proto ty regulace bohužel jsou velmi slabé a nemají dostatečnou sílu , aby něco vymohly .
And I apologise for ending this on such a depressing down note , but I honestly don 't see a way out .	A bohužel jsem pesimista , ale nevidím , jak z toho ven .
Thank you very much .	Děkuji .
